WWWWWWWWWWWWWWWWWWWWWWWWW
W         W             W
W    C    W             W
W         W             W
W    T    W             W
W         W             W
W         W             W
WWWWWWWW  W             W
W                       W
W                       W
W                       W
W                       W
W                       W
W                       W
W                       W
W                       W
W                       W
W           C           W
W                       W
W                       W
W                       W
W              T        W
W         E             W
W                       W
WWWWWWWWWWWWWWWWWWWWWWWWW