WWWWWWWWWWEEEWWWWWWWWWWWW
W                       W
W    C            S     W
W                       W
W    T                  W
W                 F     W
W                       W
W                       W
W                       W
W                       W
W       O               W
W                 B     W
W                       W
W                       W
W                       W
W                       W
W                       W
W                       W
W                       W
W                       W
W                       W
W                       W
W                       W
W                       W
WWWWWWWWWWWWWWWWWWWWWWWWW