












        WWWWWWEEEWWWWWWWHHHWWWWWW
        W                       W
        W                       W
        W                       W
        W                       W
        W                       W
        W                       W
        W                       W
        W                       W
        W                       W
        W                       W
        W                       W
        W                       W
        W                       W
        W                       W
        W                       W
        W                       W
        WWWWWWWWWWWWWWWWWWWWWWWWW